7
7
#######
#C....#
#.###.#
#.#...#
#.#.###
#.....#
#######
